backward|back|bk
forward|fd
left|lt
right|rt
pendown|pd
penerase|pe
penup|pu
if
north|n
northwest|nw
west|w
southwest|sw
south|s
southeast|se
east|e
northeast|ne
hideturtle|ht
showturtle|st
clear|cg
clearcommands|cc
to
talkto|tto
end
ifelse
floodfill|fill
setheading|seth
setcolor|setc
setbackground|setbg
setxy
setposition|setpos
newturtle
removeturtle|remove
setturtlecolor
setturtlesize
repeat
make
home
setpensize
